1111111111111111111
1P101C0010100000001
1010101110111111101
1000001000100000001
1011111010101111111
1000000010000000001
1011010101111111101
10000101010000C0001
11110C00010000001E1
1111111111111111111
