1111111111111111111
1010100010100000001
1010101110111111101
1000001000100000001
1011111010101111111
1000000010000000001
1011010101111111101
1000010101000000001
1111000001000000101
1111111111111111111
