SO resources/textures/wood.png
NO resources/textures/stone.png
WE resources/textures/cobblestone.png
EA resources/textures/colorstone.png
F 2,166,48
C 10,241,245

   1111111111111111111111111
   1000000000000000000100001
1111000000100000000000000001
1000000001111110000000111111
1000100001    10000000000001
1000000001111110000000001111
1000000000000000000000000001
1000000000000000000000011011
1000001110000000111110010001
1000001 10000000000000010S01
1111111 11111111111111111111